4 4 4 4 0 0 0 5 5 5 5 5 5 5 5 5
4 4 4 4 0 0 5 5 5 5 5 5 5 5 5 5
4 4 4 4 0 0 5 5 5 5 5 5 5 5 5 5
3 3 3 3 0 0 5 5 5 5 5 5 5 5 5 5
1 1 1 1 1 0 5 5 5 5 5 5 5 5 5 5
1 1 1 1 1 0 0 5 5 5 5 5 5 5 5 5
1 1 1 1 1 0 0 0 5 5 5 5 5 5 5 5
1 1 1 7 7 7 7 0 0 5 5 5 5 5 5 5
7 7 7 7 2 2 0 0 0 0 5 5 5 5 5 5
6 6 2 2 2 2 2 2 0 0 0 0 0 0 5 5
6 6 6 2 2 2 2 2 2 2 2 2 0 0 0 0
6 6 6 6 6 6 6 6 6 2 2 2 2 2 0 0