0 1 2 3 4 5 0 0 0 0 0 0 0 0 0 0
0 0 0 0 0 0 0 0 0 0 0 0 0 0 0 0
0 0 0 0 0 0 0 0 0 0 0 0 0 0 0 0
0 0 0 0 0 0 0 0 0 0 0 0 0 0 0 0
0 0 0 0 0 0 0 0 0 0 0 1 1 0 0 0
0 0 0 0 0 0 0 0 0 0 2 2 5 1 0 0
0 0 0 0 0 0 0 0 0 0 1 1 5 1 0 0
0 0 0 0 0 0 0 0 0 1 1 5 5 0 0 0
0 0 0 0 0 0 0 0 0 1 5 5 1 0 0 0
0 4 4 4 4 4 0 0 1 1 5 5 5 0 0 0
0 4 4 4 4 4 0 0 1 1 5 5 5 0 0 0
0 3 3 3 3 3 0 0 0 1 5 1 5 0 0 0